11111111
1P000001
100C0001
1C0X00E1
11111111