11111111
1P000001
1C0C0001
1CX000E1
11111111