11111111
1P000001
100C0011
1C0X01E1
11111111