11111111
1P000001
100C00011
100000E1
11111111