11111111
1P000X01
100C0X01
1C0X00E1
11111111