11111111
1P000X01
100C0001
1C0X00E1
11111111